NO includes/textures/brik.png
SO includes/textures/brik.png
WE includes/textures/brik.png
EA includes/textures/brik3.png

F 220,100,0
C 225,30,0

1111111111111111111111111
1000000000110000000000001
10110000011100000000P00001
10010000000000000000000011111111
111111111011000001110000000000001
100000000011000001110111111111111
1111011111  11011100000000001
11110111  1 1101 101010010001
1100000011010101 1000000100011
10000000000000001100000010000F1
100000000000000001101010010001
1100000111010101111101111000111
11110111 1110101 10111101N001
111111      1 1   11101111111